-----@-@---@---@---@-----@---@--
@@-@@@-@-@-@-@@@-@-@-@@@-@@@@@-@
---@---@-@-------@-@-@-@-------@
@@-@-@@@-@@@-@@@@@-@@@-@-@@@@@@@
---------@-----@-----@-@-@-----@
@@@@-@-@-@-@@@-@-@@@-@-@@@-@@@-@
-@---@-@---@---@-@---@-----@----
-@-@-@@@-@@@@@@@-@@@-@@@-@@@@@-@
---@---@-@---@-----@-------@-@-@
@@@@-@-@@@-@@@@@-@-@@@@@-@-@-@@@
-----@---------@-@-@---@-@------
@@@@-@@@@@@@-@-@-@-@-@@@-@@@-@-@
-----@-------@-@-@-----@-@-@-@-@
-@@@@@@@@@-@@@@@@@-@-@-@-@-@@@-@
-----@-----@-------@-@-@-@------
@@-@-@@@@@-@-@@@@-@@@@-@-@@@@@@@
---@-@-@---@-@-------@-@---@---@
-@@@@@-@@@-@@@-@@@@@-@-@-@-@@@-@
-@---@-@---------@-@-@-@-@-@-@--
@@-@@@-@@@@@-@@@@@-@-@@@-@@@-@@-
---@-----------@-----------@--@-
@@-@-@@@-@@@-@@@-@-@@@-@@@-@-@@-
-------@-@---@---@-@-@-@-@-@--@-
@@@@-@---@-@-@-@-@-@-@---@--@---